10x25
*************************
*   R   R      *  R *   *
* *  R *  *  *     *    *
* H                     O
*   *        *   *      *
*      *     *       *  *
*     * R    *     *    *
*   *   *           *   *
*    R    *     * *  *  *
*************************

